cancer,ndata,s1data,s2data,s3data,s4data,total,imbalance ratio
KICH,25,21,25,14,6,66,2.64
COAD,41,45,107,80,38,270,6.585365854
LIHC,50,165,83,81,6,335,6.7
KIRC,72,265,57,126,81,529,7.347222222
KIRP,32,168,21,49,14,252,7.875
THCA,59,283,54,110,54,501,8.491525424
LUAD,59,278,124,84,27,513,8.694915254
BRCA,113,183,610,246,20,1059,9.371681416
LUSC,51,240,156,85,7,488,9.568627451
HNSC,44,27,75,76,266,444,10.09090909
ESCA,13,19,78,56,9,162,12.46153846
BLCA,19,4,125,127,128,384,20.21052632
